//MAP CONVERTED BY dmm2tgm.py THIS HEADER COMMENT PREVENTS RECONVERSION, DO NOT REMOVE
"ac" = (
/turf/closed/shuttle/argo/r5,
/area/template_noop)
"aj" = (
/turf/closed/shuttle/argo/t3,
/area/template_noop)
"ao" = (
/turf/open/space/basic,
/area/template_noop)
"aw" = (
/obj/machinery/cic_maptable,
/obj/structure/table/mainship,
/obj/structure/window/reinforced/argo/toughened,
/obj/structure/window/reinforced/argo/toughened{
	dir = 4
	},
/turf/open/floor/mainship/black/full,
/area/shuttle/dropship/alamo)
"aM" = (
/obj/machinery/door/window{
	dir = 8
	},
/turf/open/floor/mainship/black/full,
/area/space)
"aN" = (
/obj/structure/dropship_piece/argo/bb4,
/turf/open/space/basic,
/area/template_noop)
"aQ" = (
/obj/structure/dropship_piece/argo/l10,
/turf/open/space/basic,
/area/template_noop)
"aZ" = (
/obj/machinery/power/fusion_engine/random,
/turf/open/floor/mainship/black/full,
/area/shuttle/dropship/alamo)
"bh" = (
/turf/closed/shuttle/argo/b1,
/area/shuttle/dropship/alamo)
"bu" = (
/turf/closed/shuttle/argo/transparent/right{
	dir = 1
	},
/area/template_noop)
"bD" = (
/obj/item/bedsheet/medical,
/obj/structure/bed,
/obj/structure/window/reinforced/argo{
	dir = 4
	},
/obj/structure/window/reinforced/argo{
	dir = 1
	},
/turf/open/floor/mainship/black/full,
/area/space)
"bK" = (
/turf/closed/shuttle/argo/t4,
/area/template_noop)
"bV" = (
/turf/closed/shuttle/argo/t5,
/area/template_noop)
"bY" = (
/obj/machinery/cryopod/right,
/turf/open/floor/mainship/black/full,
/area/shuttle/dropship/alamo)
"bZ" = (
/obj/structure/window/reinforced/argo{
	dir = 4
	},
/obj/machinery/atmospherics/components/unary/cryo_cell,
/turf/open/floor/mainship/black/full,
/area/shuttle/dropship/alamo)
"cl" = (
/obj/machinery/power/fusion_engine/random,
/obj/structure/cable,
/turf/open/floor/mainship/black/full,
/area/space)
"cL" = (
/obj/machinery/sleep_console,
/turf/open/floor/mainship/black/full,
/area/shuttle/dropship/alamo)
"cP" = (
/obj/structure/table/mainship,
/obj/machinery/computer/secure_data,
/turf/open/floor/mainship/black/full,
/area/space)
"dg" = (
/obj/machinery/body_scanconsole,
/obj/machinery/door/window{
	dir = 1
	},
/turf/open/floor/mainship/black/full,
/area/space)
"di" = (
/obj/machinery/body_scanconsole,
/obj/machinery/door/window{
	dir = 1
	},
/turf/open/floor/mainship/black/full,
/area/shuttle/dropship/alamo)
"dj" = (
/turf/closed/shuttle/argo/l2,
/area/template_noop)
"dl" = (
/obj/machinery/marine_selector/clothes,
/obj/structure/window/reinforced/argo{
	dir = 1
	},
/turf/open/floor/mainship/black/full,
/area/space)
"dC" = (
/obj/machinery/bioprinter/stocked,
/obj/structure/window/reinforced/argo{
	dir = 4
	},
/obj/structure/window/reinforced/argo{
	dir = 1
	},
/turf/open/floor/mainship/black/full,
/area/shuttle/dropship/alamo)
"dS" = (
/obj/machinery/power/monitor,
/obj/structure/window/reinforced/argo{
	dir = 1
	},
/turf/open/floor/mainship/black/full,
/area/space)
"dU" = (
/obj/structure/dropship_piece/argo/r10,
/turf/open/space/basic,
/area/template_noop)
"dW" = (
/turf/open/space/basic,
/area/space)
"ed" = (
/obj/effect/decal/warning_stripes/thin{
	dir = 1
	},
/obj/machinery/door/airlock/dropship_hatch/argo{
	dir = 8
	},
/turf/open/floor/mainship/black/full,
/area/template_noop)
"eP" = (
/obj/effect/decal/warning_stripes/thin,
/obj/machinery/door/airlock/dropship_hatch/argo,
/turf/open/floor/mainship/black/full,
/area/shuttle/dropship/alamo)
"fb" = (
/obj/machinery/vending/engivend,
/obj/structure/window/reinforced/argo{
	dir = 4
	},
/obj/structure/window/reinforced/argo{
	dir = 1
	},
/turf/open/floor/mainship/black/full,
/area/space)
"fp" = (
/obj/machinery/optable,
/obj/item/tank/anesthetic,
/obj/item/clothing/mask/breath/medical,
/obj/structure/window/reinforced/argo,
/turf/open/floor/mainship/black/full,
/area/shuttle/dropship/alamo)
"gx" = (
/obj/structure/dropship_piece/argo/l1,
/turf/open/space/basic,
/area/template_noop)
"gF" = (
/obj/structure/dropship_piece/argo/l7,
/turf/open/space/basic,
/area/template_noop)
"hr" = (
/obj/machinery/computer/security/dropship/one,
/turf/open/floor/mainship/black/full,
/area/shuttle/dropship/alamo)
"hx" = (
/obj/effect/decal/warning_stripes/thin{
	dir = 1
	},
/obj/machinery/door/airlock/dropship_hatch/argo{
	dir = 8
	},
/obj/effect/decal/warning_stripes/thin,
/turf/open/floor/mainship/black/full,
/area/template_noop)
"ia" = (
/obj/structure/window/reinforced/argo{
	dir = 4
	},
/obj/structure/window/reinforced/argo{
	dir = 1
	},
/turf/open/floor/mainship/black/full,
/area/shuttle/dropship/alamo)
"ib" = (
/obj/machinery/door/window/right,
/turf/open/floor/mainship/black/full,
/area/shuttle/dropship/alamo)
"ie" = (
/obj/machinery/door/window{
	dir = 8
	},
/turf/open/floor/mainship/black/full,
/area/shuttle/dropship/alamo)
"iC" = (
/obj/structure/window/reinforced/argo{
	dir = 8
	},
/obj/structure/window/reinforced/argo{
	dir = 1
	},
/obj/machinery/cryopod,
/turf/open/floor/mainship/black/full,
/area/shuttle/dropship/alamo)
"iT" = (
/obj/machinery/computer/dropship_weapons/dropship1,
/obj/structure/window/reinforced/argo/window{
	dir = 4
	},
/turf/open/floor/mainship/black/full,
/area/shuttle/dropship/alamo)
"iY" = (
/obj/structure/bed,
/obj/item/bedsheet/medical,
/obj/structure/window/reinforced/argo{
	dir = 4
	},
/turf/open/floor/mainship/black/full,
/area/space)
"jm" = (
/obj/structure/bed/chair/dropship/passenger,
/turf/open/floor/mainship/black/full,
/area/shuttle/dropship/alamo)
"jv" = (
/turf/closed/shuttle/argo/l6,
/area/template_noop)
"jD" = (
/obj/machinery/power/terminal{
	dir = 1
	},
/obj/structure/cable,
/turf/open/floor/mainship/black/full,
/area/space)
"jJ" = (
/obj/structure/bed/chair/dropship/passenger{
	dir = 8
	},
/obj/effect/decal/warning_stripes/thin{
	dir = 4
	},
/turf/open/floor/mainship/black/full,
/area/space)
"ka" = (
/obj/effect/decal/warning_stripes/thin{
	dir = 10
	},
/turf/open/floor/mainship/black/full,
/area/space)
"kl" = (
/obj/structure/table/reinforced,
/obj/machinery/door/window{
	dir = 1
	},
/obj/item/reagent_containers/glass/beaker/bluespace,
/turf/open/floor/mainship/black/full,
/area/shuttle/dropship/alamo)
"ko" = (
/obj/effect/decal/warning_stripes/thin{
	dir = 6
	},
/obj/effect/decal/warning_stripes/thin{
	dir = 10
	},
/turf/open/floor/mainship/black/full,
/area/shuttle/dropship/alamo)
"kw" = (
/obj/structure/table/reinforced,
/obj/item/storage/surgical_tray,
/obj/structure/window/reinforced/argo{
	dir = 4
	},
/obj/structure/window/reinforced/argo,
/turf/open/floor/mainship/black/full,
/area/shuttle/dropship/alamo)
"kK" = (
/obj/structure/window/reinforced/argo,
/obj/structure/bed,
/obj/item/bedsheet/brown,
/obj/machinery/door/window{
	dir = 8
	},
/turf/open/floor/mainship/black/full,
/area/space)
"kR" = (
/obj/structure/dropship_piece/argo/l8,
/turf/open/space/basic,
/area/template_noop)
"kX" = (
/obj/structure/window/reinforced/argo{
	dir = 8
	},
/obj/structure/window/reinforced/argo,
/turf/open/floor/mainship/black/full,
/area/shuttle/dropship/alamo)
"lB" = (
/obj/machinery/sleeper,
/turf/open/floor/mainship/black/full,
/area/space)
"lQ" = (
/obj/structure/window/reinforced/argo{
	dir = 1
	},
/obj/machinery/door/window{
	dir = 8
	},
/obj/structure/bed/chair/comfy{
	dir = 8
	},
/turf/open/floor/mainship/black/full,
/area/shuttle/dropship/alamo)
"lW" = (
/obj/effect/decal/warning_stripes/thin{
	dir = 10
	},
/turf/open/floor/mainship/black/full,
/area/shuttle/dropship/alamo)
"mp" = (
/obj/machinery/bioprinter/stocked,
/obj/structure/window/reinforced/argo{
	dir = 4
	},
/obj/structure/window/reinforced/argo{
	dir = 1
	},
/turf/open/floor/mainship/black/full,
/area/space)
"mt" = (
/turf/closed/shuttle/argo/b5,
/area/shuttle/dropship/alamo)
"mA" = (
/obj/structure/window/reinforced/argo{
	dir = 1
	},
/obj/structure/window/reinforced/argo{
	dir = 4
	},
/obj/machinery/vending/engivend,
/turf/open/floor/mainship/black/full,
/area/shuttle/dropship/alamo)
"na" = (
/obj/machinery/loadout_vendor,
/turf/open/floor/mainship/black/full,
/area/shuttle/dropship/alamo)
"nz" = (
/obj/structure/dropship_piece/argo/l8,
/turf/open/space/basic,
/area/shuttle/dropship/alamo)
"nQ" = (
/obj/machinery/iv_drip,
/obj/structure/window/reinforced/argo{
	dir = 1
	},
/turf/open/floor/mainship/black/full,
/area/space)
"oa" = (
/obj/structure/window/reinforced/argo,
/turf/open/floor/mainship/black/full,
/area/shuttle/dropship/alamo)
"oz" = (
/obj/machinery/marine_selector/clothes,
/turf/open/floor/mainship/black/full,
/area/shuttle/dropship/alamo)
"oA" = (
/obj/structure/dropship_piece/argo/r7,
/turf/open/space/basic,
/area/template_noop)
"oB" = (
/obj/effect/decal/warning_stripes/thin{
	dir = 10
	},
/obj/effect/decal/warning_stripes/thin{
	dir = 9
	},
/turf/open/floor/mainship/black/full,
/area/space)
"oK" = (
/obj/structure/bed/chair/dropship/pilot{
	dir = 1
	},
/turf/open/floor/mainship/black/full,
/area/shuttle/dropship/alamo)
"oZ" = (
/obj/effect/decal/warning_stripes/thin{
	dir = 1
	},
/obj/machinery/door/airlock/dropship_hatch/argo,
/turf/open/floor/mainship/black/full,
/area/template_noop)
"pH" = (
/obj/machinery/optable,
/obj/item/tank/anesthetic,
/obj/item/clothing/mask/breath/medical,
/obj/structure/window/reinforced/argo,
/turf/open/floor/mainship/black/full,
/area/space)
"qg" = (
/obj/machinery/bodyscanner,
/obj/structure/window/reinforced/argo{
	dir = 1
	},
/turf/open/floor/mainship/black/full,
/area/space)
"qx" = (
/obj/structure/window/reinforced/argo,
/obj/structure/window/reinforced/argo{
	dir = 8
	},
/obj/machinery/vending/security,
/turf/open/floor/mainship/black/full,
/area/shuttle/dropship/alamo)
"qP" = (
/obj/structure/dropship_piece/argo/r1,
/turf/open/space/basic,
/area/template_noop)
"rk" = (
/obj/structure/closet/secure_closet/evidence,
/obj/structure/window/reinforced/argo{
	dir = 8
	},
/turf/open/floor/mainship/black/full,
/area/shuttle/dropship/alamo)
"rz" = (
/obj/structure/dropship_piece/argo/bb3,
/turf/open/space/basic,
/area/template_noop)
"sj" = (
/obj/structure/window/reinforced/argo,
/obj/structure/sink{
	dir = 1
	},
/turf/open/floor/mainship/black/full,
/area/shuttle/dropship/alamo)
"so" = (
/obj/structure/dropship_piece/argo/ll9,
/turf/open/space/basic,
/area/template_noop)
"sr" = (
/obj/effect/decal/warning_stripes/thin{
	dir = 6
	},
/turf/open/floor/mainship/black/full,
/area/shuttle/dropship/alamo)
"sP" = (
/turf/closed/shuttle/argo/l3,
/area/template_noop)
"sT" = (
/obj/structure/window/reinforced/argo{
	dir = 8
	},
/obj/structure/window/reinforced/argo{
	dir = 1
	},
/obj/structure/bed/chair/dropship/passenger{
	dir = 4
	},
/turf/open/floor/mainship/black/full,
/area/shuttle/dropship/alamo)
"tB" = (
/obj/structure/dropship_piece/argo/r8,
/turf/open/space/basic,
/area/template_noop)
"tC" = (
/obj/item/radio/intercom/dropship{
	pixel_x = 21;
	pixel_y = 16
	},
/turf/open/floor/mainship/black/full,
/area/shuttle/dropship/alamo)
"ua" = (
/turf/closed/shuttle/argo/transparent/left{
	dir = 1
	},
/area/template_noop)
"uo" = (
/obj/effect/decal/warning_stripes/thin,
/turf/open/floor/mainship/black/full,
/area/space)
"uW" = (
/obj/structure/window/reinforced/argo,
/turf/open/floor/mainship/black/full,
/area/space)
"va" = (
/obj/structure/window/reinforced/argo,
/obj/structure/toilet,
/obj/machinery/door/window{
	dir = 8
	},
/turf/open/floor/mainship/black/full,
/area/shuttle/dropship/alamo)
"vg" = (
/obj/machinery/door/airlock/multi_tile/mainship/dropshiprear/argo{
	dir = 1
	},
/turf/open/floor/mainship/black/full,
/area/shuttle/dropship/alamo)
"vA" = (
/obj/structure/sink{
	dir = 4
	},
/obj/structure/window/reinforced/argo{
	dir = 4
	},
/turf/open/floor/mainship/black/full,
/area/space)
"vF" = (
/obj/structure/bed/chair/dropship/pilot{
	dir = 1
	},
/obj/structure/window/reinforced/argo/window{
	dir = 4
	},
/turf/open/floor/mainship/black/full,
/area/shuttle/dropship/alamo)
"wI" = (
/obj/machinery/cic_maptable,
/obj/structure/table/mainship,
/obj/structure/window/reinforced/argo/toughened,
/turf/open/floor/mainship/black/full,
/area/shuttle/dropship/alamo)
"wX" = (
/obj/effect/decal/warning_stripes/thin,
/obj/effect/decal/warning_stripes/thin{
	dir = 1
	},
/turf/open/floor/mainship/black/full,
/area/shuttle/dropship/alamo)
"wZ" = (
/obj/effect/decal/warning_stripes/thin{
	dir = 6
	},
/turf/open/floor/mainship/black/full,
/area/space)
"xl" = (
/obj/machinery/vending/marine/shared,
/turf/open/floor/mainship/black/full,
/area/shuttle/dropship/alamo)
"xv" = (
/obj/machinery/door/airlock/dropship_hatch/argo{
	dir = 8
	},
/turf/open/floor/mainship/black/full,
/area/template_noop)
"xB" = (
/obj/structure/toilet,
/turf/open/floor/mainship/black/full,
/area/space)
"xZ" = (
/obj/effect/decal/warning_stripes/thin,
/turf/open/floor/mainship/black/full,
/area/shuttle/dropship/alamo)
"Ah" = (
/turf/open/floor/mainship/black/full,
/area/space)
"As" = (
/obj/structure/dropship_piece/argo/bb2,
/turf/open/space/basic,
/area/template_noop)
"Az" = (
/obj/effect/decal/warning_stripes/thin{
	dir = 6
	},
/obj/effect/decal/warning_stripes/thin{
	dir = 5
	},
/turf/open/floor/mainship/black/full,
/area/shuttle/dropship/alamo)
"AG" = (
/obj/structure/bed,
/obj/item/bedsheet/hos,
/obj/structure/window/reinforced/argo,
/obj/structure/window/reinforced/argo{
	dir = 8
	},
/turf/open/floor/mainship/black/full,
/area/space)
"AK" = (
/obj/effect/decal/warning_stripes/thin{
	dir = 9
	},
/obj/effect/decal/warning_stripes/thin{
	dir = 10
	},
/turf/open/floor/mainship/black/full,
/area/space)
"Bd" = (
/obj/effect/decal/warning_stripes/thin{
	dir = 10
	},
/obj/effect/decal/warning_stripes/thin{
	dir = 6
	},
/turf/open/floor/mainship/black/full,
/area/space)
"Bj" = (
/obj/machinery/chem_dispenser,
/turf/open/floor/mainship/black/full,
/area/shuttle/dropship/alamo)
"Cn" = (
/obj/structure/toilet,
/obj/structure/window/reinforced/argo{
	dir = 4
	},
/turf/open/floor/mainship/black/full,
/area/space)
"CO" = (
/obj/machinery/atmospherics/components/unary/cryo_cell,
/turf/open/floor/mainship/black/full,
/area/space)
"CP" = (
/obj/machinery/door/window{
	dir = 1
	},
/turf/open/floor/mainship/black/full,
/area/shuttle/dropship/alamo)
"CX" = (
/turf/closed/shuttle/argo/l5,
/area/shuttle/dropship/alamo)
"Da" = (
/obj/machinery/door/airlock/multi_tile/mainship/dropshiprear/argo{
	dir = 2
	},
/turf/open/space/basic,
/area/shuttle/dropship/alamo)
"Dg" = (
/obj/machinery/bodyscanner,
/obj/structure/window/reinforced/argo{
	dir = 1
	},
/turf/open/floor/mainship/black/full,
/area/shuttle/dropship/alamo)
"Dw" = (
/obj/structure/bed/chair/dropship/passenger{
	dir = 4
	},
/turf/open/floor/mainship/black/full,
/area/space)
"DC" = (
/obj/structure/closet/secure_closet/evidence,
/obj/structure/window/reinforced/argo{
	dir = 4
	},
/turf/open/floor/mainship/black/full,
/area/space)
"Ee" = (
/obj/structure/toilet,
/obj/machinery/door/window,
/obj/structure/window/reinforced/argo,
/obj/structure/window/reinforced/argo{
	dir = 8
	},
/turf/open/floor/mainship/black/full,
/area/space)
"Ej" = (
/obj/structure/bed,
/obj/item/bedsheet/brown,
/obj/machinery/door/window{
	dir = 8
	},
/obj/structure/window/reinforced/argo,
/turf/open/floor/mainship/black/full,
/area/shuttle/dropship/alamo)
"EI" = (
/obj/machinery/computer/camera_advanced/overwatch,
/obj/structure/table/mainship,
/obj/structure/window/reinforced/argo{
	dir = 1
	},
/obj/structure/window/reinforced/argo/toughened{
	dir = 4
	},
/turf/open/floor/mainship/black/full,
/area/shuttle/dropship/alamo)
"ES" = (
/obj/structure/window/reinforced/argo{
	dir = 8
	},
/turf/open/floor/mainship/black/full,
/area/shuttle/dropship/alamo)
"Fj" = (
/obj/structure/table/mainship,
/obj/structure/window/reinforced/argo{
	dir = 8
	},
/obj/structure/window/reinforced/argo{
	dir = 1
	},
/turf/open/floor/mainship/black/full,
/area/space)
"FB" = (
/obj/machinery/power/terminal{
	dir = 4
	},
/turf/open/floor/mainship/black/full,
/area/shuttle/dropship/alamo)
"Gg" = (
/obj/structure/dropship_piece/argo/l4,
/turf/open/space/basic,
/area/template_noop)
"GA" = (
/obj/effect/decal/warning_stripes/thin{
	dir = 1
	},
/turf/open/floor/mainship/black/full,
/area/shuttle/dropship/alamo)
"GH" = (
/obj/structure/window/reinforced/argo{
	dir = 1
	},
/obj/machinery/door/window{
	dir = 8
	},
/obj/structure/bed/chair/comfy{
	dir = 8
	},
/obj/structure/window/reinforced/argo,
/turf/open/floor/mainship/black/full,
/area/shuttle/dropship/alamo)
"HF" = (
/obj/machinery/door/window,
/obj/structure/window/reinforced/argo{
	dir = 4
	},
/turf/open/floor/mainship/black/full,
/area/space)
"ID" = (
/obj/effect/decal/warning_stripes/thin{
	dir = 9
	},
/obj/effect/decal/warning_stripes/thin{
	dir = 5
	},
/turf/open/floor/mainship/black/full,
/area/space)
"IE" = (
/obj/structure/sink,
/turf/open/floor/mainship/black/full,
/area/space)
"IV" = (
/obj/structure/window/reinforced/argo,
/obj/structure/table/mainship,
/obj/machinery/faxmachine/brig,
/turf/open/floor/mainship/black/full,
/area/space)
"IW" = (
/turf/closed/shuttle/argo/r3,
/area/template_noop)
"Jf" = (
/obj/machinery/door/window/right{
	dir = 8
	},
/turf/open/floor/mainship/black/full,
/area/shuttle/dropship/alamo)
"Jz" = (
/obj/structure/window/reinforced/argo{
	dir = 8
	},
/obj/structure/bed/chair/dropship/passenger{
	dir = 4
	},
/turf/open/floor/mainship/black/full,
/area/shuttle/dropship/alamo)
"Kp" = (
/obj/structure/dropship_piece/argo/bb1,
/turf/open/space/basic,
/area/template_noop)
"KG" = (
/obj/structure/window/reinforced/argo{
	dir = 1
	},
/turf/open/floor/mainship/black/full,
/area/space)
"KH" = (
/obj/structure/bed/chair/dropship/passenger{
	dir = 8
	},
/obj/structure/window/reinforced/argo/window{
	dir = 4
	},
/turf/open/floor/mainship/black/full,
/area/shuttle/dropship/alamo)
"KN" = (
/obj/machinery/fuelcell_recycler,
/turf/open/floor/mainship/black/full,
/area/space)
"Lm" = (
/obj/effect/decal/warning_stripes/thin{
	dir = 6
	},
/obj/effect/decal/warning_stripes/thin{
	dir = 5
	},
/turf/open/floor/mainship/black/full,
/area/space)
"LF" = (
/obj/structure/toilet,
/obj/machinery/door/window{
	dir = 8
	},
/obj/structure/window/reinforced/argo,
/turf/open/floor/mainship/black/full,
/area/space)
"Mk" = (
/turf/closed/shuttle/argo/l6,
/area/shuttle/dropship/alamo)
"Mw" = (
/obj/structure/sink{
	dir = 8
	},
/turf/open/floor/mainship/black/full,
/area/space)
"Mx" = (
/obj/effect/decal/warning_stripes/thin,
/obj/machinery/door/airlock/dropship_hatch/argo{
	dir = 8
	},
/turf/open/floor/mainship/black/full,
/area/shuttle/dropship/alamo)
"ML" = (
/turf/closed/shuttle/argo/r6,
/area/template_noop)
"MO" = (
/obj/machinery/door/window,
/turf/open/floor/mainship/black/full,
/area/space)
"MV" = (
/obj/machinery/door/window,
/obj/structure/window/reinforced/argo{
	dir = 4
	},
/turf/open/floor/mainship/black/full,
/area/shuttle/dropship/alamo)
"Nw" = (
/obj/structure/window/reinforced/argo{
	dir = 4
	},
/obj/structure/window/reinforced/argo{
	dir = 1
	},
/obj/machinery/vending/medical,
/turf/open/floor/mainship/black/full,
/area/shuttle/dropship/alamo)
"Nx" = (
/turf/open/space/basic,
/area/shuttle/dropship/alamo)
"NF" = (
/obj/structure/table/mainship,
/obj/structure/window/reinforced/argo{
	dir = 4
	},
/turf/open/floor/mainship/black/full,
/area/space)
"NO" = (
/obj/machinery/door/window{
	dir = 2
	},
/turf/open/floor/mainship/black/full,
/area/space)
"Ol" = (
/obj/structure/bed,
/obj/item/bedsheet/brown,
/obj/machinery/door/window{
	dir = 8
	},
/obj/structure/window/reinforced/argo,
/turf/open/floor/mainship/black/full,
/area/space)
"On" = (
/obj/effect/decal/warning_stripes/thin{
	dir = 1
	},
/obj/effect/decal/warning_stripes/thin{
	dir = 6
	},
/obj/effect/decal/warning_stripes/thin{
	dir = 10
	},
/turf/open/floor/mainship/black/full,
/area/shuttle/dropship/alamo)
"Op" = (
/obj/effect/decal/warning_stripes/thin{
	dir = 9
	},
/obj/effect/decal/warning_stripes/thin{
	dir = 5
	},
/turf/open/floor/mainship/black/full,
/area/shuttle/dropship/alamo)
"Ou" = (
/obj/structure/dropship_piece/argo/r9,
/turf/open/space/basic,
/area/template_noop)
"ON" = (
/obj/machinery/iv_drip,
/obj/structure/window/reinforced/argo{
	dir = 1
	},
/turf/open/floor/mainship/black/full,
/area/shuttle/dropship/alamo)
"OS" = (
/obj/machinery/sleeper,
/turf/open/floor/mainship/black/full,
/area/shuttle/dropship/alamo)
"Po" = (
/obj/effect/decal/warning_stripes/thin{
	dir = 5
	},
/obj/effect/decal/warning_stripes/thin{
	dir = 9
	},
/turf/open/floor/mainship/black/full,
/area/space)
"QM" = (
/obj/structure/dropship_piece/argo/r4,
/turf/open/space/basic,
/area/template_noop)
"QW" = (
/obj/structure/window/reinforced/argo,
/obj/structure/bed,
/obj/item/bedsheet/brown,
/obj/machinery/door/window{
	dir = 8
	},
/turf/open/floor/mainship/black/full,
/area/shuttle/dropship/alamo)
"Rd" = (
/obj/machinery/computer/camera_advanced/overwatch,
/obj/structure/table/mainship,
/obj/structure/window/reinforced/argo{
	dir = 1
	},
/turf/open/floor/mainship/black/full,
/area/shuttle/dropship/alamo)
"RH" = (
/obj/machinery/door/window{
	dir = 1
	},
/obj/structure/window/reinforced/argo{
	dir = 4
	},
/turf/open/floor/mainship/black/full,
/area/space)
"RR" = (
/obj/structure/bed,
/obj/item/bedsheet/hos,
/obj/structure/window/reinforced/argo{
	dir = 4
	},
/turf/open/floor/mainship/black/full,
/area/space)
"RX" = (
/obj/machinery/sleep_console,
/turf/open/floor/mainship/black/full,
/area/space)
"SH" = (
/obj/structure/bed,
/obj/item/bedsheet/brown,
/obj/machinery/door/window,
/obj/structure/window/reinforced/argo,
/obj/structure/window/reinforced/argo{
	dir = 8
	},
/turf/open/floor/mainship/black/full,
/area/space)
"SP" = (
/turf/closed/shuttle/argo/b3,
/area/shuttle/dropship/alamo)
"Tn" = (
/obj/machinery/chem_master,
/obj/structure/window/reinforced/argo{
	dir = 1
	},
/turf/open/floor/mainship/black/full,
/area/shuttle/dropship/alamo)
"Tp" = (
/obj/structure/window/reinforced/argo,
/obj/machinery/marine_selector/clothes,
/turf/open/floor/mainship/black/full,
/area/shuttle/dropship/alamo)
"Tu" = (
/obj/structure/window/reinforced/argo{
	dir = 8
	},
/obj/machinery/cryopod,
/turf/open/floor/mainship/black/full,
/area/shuttle/dropship/alamo)
"Ty" = (
/obj/machinery/door/window{
	dir = 1
	},
/turf/open/floor/mainship/black/full,
/area/space)
"TO" = (
/obj/structure/window/reinforced/argo{
	dir = 1
	},
/obj/machinery/fuelcell_recycler,
/turf/open/floor/mainship/black/full,
/area/shuttle/dropship/alamo)
"Uh" = (
/obj/effect/decal/warning_stripes/thin{
	dir = 1
	},
/turf/open/floor/mainship/black/full,
/area/space)
"Uq" = (
/turf/closed/shuttle/argo/c1{
	dir = 1
	},
/area/template_noop)
"Vj" = (
/obj/structure/window/reinforced/argo{
	dir = 8
	},
/obj/structure/window/reinforced/argo,
/obj/structure/closet/secure_closet/personal,
/turf/open/floor/mainship/black/full,
/area/shuttle/dropship/alamo)
"Vy" = (
/obj/structure/window/reinforced/argo,
/obj/structure/bed/chair/comfy{
	dir = 4
	},
/turf/open/floor/mainship/black/full,
/area/shuttle/dropship/alamo)
"VL" = (
/obj/machinery/computer/shuttle/marine_dropship/one,
/turf/open/floor/mainship/black/full,
/area/shuttle/dropship/alamo)
"VT" = (
/obj/machinery/door/window{
	dir = 2
	},
/turf/open/floor/mainship/black/full,
/area/shuttle/dropship/alamo)
"VW" = (
/obj/structure/window/reinforced/argo{
	dir = 8
	},
/obj/structure/window/reinforced/argo,
/obj/machinery/shower,
/obj/machinery/door/window,
/turf/open/floor/mainship/black/full,
/area/shuttle/dropship/alamo)
"Wz" = (
/turf/closed/shuttle/argo/r2,
/area/template_noop)
"WC" = (
/obj/structure/table/reinforced,
/obj/item/storage/surgical_tray,
/obj/structure/window/reinforced/argo{
	dir = 4
	},
/obj/structure/window/reinforced/argo,
/turf/open/floor/mainship/black/full,
/area/space)
"WD" = (
/obj/structure/bed/chair/dropship/passenger{
	dir = 4
	},
/obj/effect/decal/warning_stripes/thin{
	dir = 8
	},
/turf/open/floor/mainship/black/full,
/area/shuttle/dropship/alamo)
"WJ" = (
/obj/machinery/vending/medical,
/obj/structure/window/reinforced/argo{
	dir = 8
	},
/turf/open/floor/mainship/black/full,
/area/space)
"WO" = (
/obj/structure/table/mainship,
/obj/machinery/computer/secure_data,
/turf/open/floor/mainship/black/full,
/area/shuttle/dropship/alamo)
"WX" = (
/obj/structure/dropship_piece/argo/l7,
/turf/open/space/basic,
/area/shuttle/dropship/alamo)
"Xc" = (
/turf/closed/shuttle/argo/l5,
/area/template_noop)
"Xj" = (
/obj/structure/window/reinforced/argo,
/obj/structure/bed,
/obj/item/bedsheet/brown,
/obj/machinery/door/window,
/obj/structure/window/reinforced/argo{
	dir = 8
	},
/turf/open/floor/mainship/black/full,
/area/space)
"Xo" = (
/obj/machinery/power/smes/preset,
/turf/open/floor/mainship/black/full,
/area/space)
"Xp" = (
/obj/structure/table/mainship,
/obj/machinery/faxmachine/brig,
/obj/structure/window/reinforced/argo,
/turf/open/floor/mainship/black/full,
/area/shuttle/dropship/alamo)
"Xq" = (
/obj/effect/decal/warning_stripes/thin{
	dir = 6
	},
/obj/effect/decal/warning_stripes/thin{
	dir = 10
	},
/turf/open/floor/mainship/black/full,
/area/space)
"XN" = (
/obj/structure/window/reinforced/argo{
	dir = 1
	},
/obj/machinery/cryopod/right,
/turf/open/floor/mainship/black/full,
/area/shuttle/dropship/alamo)
"XW" = (
/obj/structure/bed/chair/dropship/passenger{
	dir = 4
	},
/turf/open/floor/mainship/black/full,
/area/shuttle/dropship/alamo)
"XZ" = (
/obj/structure/window/reinforced/argo{
	dir = 4
	},
/obj/machinery/vending/MarineMed/Blood,
/turf/open/floor/mainship/black/full,
/area/shuttle/dropship/alamo)
"Yb" = (
/turf/closed/shuttle/argo/b4,
/area/shuttle/dropship/alamo)
"Ye" = (
/obj/structure/bed/chair/dropship/passenger,
/obj/effect/decal/warning_stripes/thin{
	dir = 1
	},
/turf/open/floor/mainship/black/full,
/area/space)
"Yx" = (
/turf/closed/shuttle/argo/b2,
/area/shuttle/dropship/alamo)
"YC" = (
/obj/effect/decal/warning_stripes/thin{
	dir = 9
	},
/turf/open/floor/mainship/black/full,
/area/shuttle/dropship/alamo)
"YJ" = (
/obj/structure/dropship_piece/argo/r8,
/turf/open/space/basic,
/area/shuttle/dropship/alamo)
"YR" = (
/obj/machinery/power/smes/preset,
/obj/structure/window/reinforced/argo{
	dir = 4
	},
/turf/open/floor/mainship/black/full,
/area/shuttle/dropship/alamo)
"Za" = (
/obj/machinery/vending/MarineMed/Blood,
/obj/structure/window/reinforced/argo{
	dir = 1
	},
/obj/structure/window/reinforced/argo{
	dir = 8
	},
/turf/open/floor/mainship/black/full,
/area/space)
"Zf" = (
/obj/structure/table/mainship,
/obj/structure/window/reinforced/argo{
	dir = 8
	},
/turf/open/floor/mainship/black/full,
/area/shuttle/dropship/alamo)
"Zh" = (
/obj/structure/dropship_piece/argo/bb5,
/turf/open/space/basic,
/area/template_noop)
"Zi" = (
/obj/structure/bed/chair/dropship/passenger{
	dir = 4
	},
/obj/effect/decal/warning_stripes/thin{
	dir = 8
	},
/turf/open/floor/mainship/black/full,
/area/space)
"Zj" = (
/turf/open/floor/mainship/black/full,
/area/shuttle/dropship/alamo)
"Zw" = (
/obj/structure/bed/chair/dropship/passenger{
	dir = 8
	},
/obj/effect/decal/warning_stripes/thin{
	dir = 4
	},
/turf/open/floor/mainship/black/full,
/area/shuttle/dropship/alamo)
"Zx" = (
/obj/structure/window/reinforced/argo{
	dir = 4
	},
/turf/open/floor/mainship/black/full,
/area/space)
"ZE" = (
/obj/effect/decal/warning_stripes/thin{
	dir = 1
	},
/obj/effect/decal/warning_stripes/thin,
/turf/open/floor/mainship/black/full,
/area/shuttle/dropship/alamo)
"ZJ" = (
/obj/effect/decal/warning_stripes/thin{
	dir = 5
	},
/turf/open/floor/mainship/black/full,
/area/shuttle/dropship/alamo)
"ZN" = (
/obj/structure/window/reinforced/argo,
/obj/machinery/vending/security,
/obj/structure/window/reinforced/argo{
	dir = 4
	},
/turf/open/floor/mainship/black/full,
/area/space)

(1,1,1) = {"
aQ
so
kR
gF
jv
Xc
oZ
eP
nz
WX
Mk
CX
nz
WX
Mk
Xc
xv
Gg
sP
dj
gx
"}
(2,1,1) = {"
ua
hr
oK
Rd
XW
wI
GA
xZ
Tn
Bj
Dg
XW
OS
XW
ON
fp
ZE
TO
aZ
bh
Kp
"}
(3,1,1) = {"
bu
VL
tC
CP
Zj
VT
Op
sr
kl
Zj
di
Zj
cL
Zj
CP
oa
On
CP
FB
Yx
As
"}
(4,1,1) = {"
Uq
iT
vF
EI
KH
aw
GA
xZ
Nw
XZ
ia
bZ
MV
ib
dC
kw
ZE
mA
YR
SP
rz
"}
(5,1,1) = {"
vg
WD
WD
WD
WD
WD
YC
lW
WD
WD
WD
WD
YC
lW
WD
WD
YC
WD
WD
Da
ao
"}
(6,1,1) = {"
Zj
Zj
Zj
Zj
Zj
Zj
Zj
Zj
Zj
Zj
Zj
Zj
Zj
Zj
Zj
Zj
Zj
Zj
Zj
Nx
ao
"}
(7,1,1) = {"
Zj
Zw
Zw
Zw
Zw
Zw
ZJ
sr
Zw
Zw
Zw
Zw
ZJ
sr
Zw
Zw
Az
Zw
Zw
Nx
ao
"}
(8,1,1) = {"
aj
Zf
Zf
ES
ES
kX
GA
xZ
sT
Jz
rk
qx
Jf
ie
Vj
VW
wX
iC
Tu
SP
rz
"}
(9,1,1) = {"
bK
jm
Zj
Zj
Zj
VT
Op
ko
CP
Zj
Zj
Vy
jm
Zj
VT
sj
On
CP
Zj
Yb
aN
"}
(10,1,1) = {"
bV
na
xl
oz
oz
Tp
GA
xZ
lQ
GH
WO
Xp
Ej
Ej
QW
va
wX
XN
bY
mt
Zh
"}
(11,1,1) = {"
dU
Ou
tB
oA
ML
ac
ed
Mx
YJ
oA
ML
ac
tB
oA
ML
ac
hx
QM
IW
Wz
qP
"}
(12,1,1) = {"
dW
dW
dW
dW
dW
dW
dW
dW
dW
dW
dW
dW
dW
dW
dW
dW
dW
dW
dW
dW
dW
"}
(13,1,1) = {"
dW
dW
xB
Mw
Ty
cP
IV
Uh
uo
qg
Dw
lB
nQ
pH
Ye
uo
dS
Xo
jD
cl
dW
"}
(14,1,1) = {"
dW
dW
AG
RR
KG
Ah
NO
Po
Bd
dg
Ah
RX
Ty
uW
Ye
Bd
Ty
Ah
Ah
KN
dW
"}
(15,1,1) = {"
dW
dW
Cn
vA
RH
DC
ZN
Ye
uo
bD
iY
HF
mp
WC
Ye
uo
fb
NF
Zx
MO
dW
"}
(16,1,1) = {"
dW
dW
dW
dW
dW
dW
dW
Ye
ka
Zi
Zi
AK
Zi
Zi
Ah
ka
Zi
Zi
Zi
oB
dW
"}
(17,1,1) = {"
dW
dW
dW
dW
dW
dW
dW
ID
Ah
Ah
Ah
Ah
Ah
Ah
Ah
Ah
Ah
Ah
Ah
Ah
dW
"}
(18,1,1) = {"
dW
dW
dW
dW
dW
dW
dW
Ye
wZ
jJ
jJ
Lm
jJ
jJ
Ah
wZ
jJ
jJ
jJ
Lm
dW
"}
(19,1,1) = {"
dW
dW
Ee
SH
SH
SH
Xj
Ye
uo
Za
WJ
aM
dW
dW
Ye
uo
Fj
dW
dW
dW
dW
"}
(20,1,1) = {"
dW
dW
IE
Ty
Ah
Ah
NO
Po
Xq
Ty
Ah
Ah
dW
dW
Ye
Bd
Ty
dW
dW
dW
dW
"}
(21,1,1) = {"
dW
dW
LF
Ol
Ol
Ol
kK
Uh
uo
KG
CO
Ah
dW
dW
Ye
uo
dl
dW
dW
dW
dW
"}
(22,1,1) = {"
dW
dW
dW
dW
dW
dW
dW
dW
dW
dW
dW
dW
dW
dW
dW
dW
dW
dW
dW
dW
dW
"}
