//MAP CONVERTED BY dmm2tgm.py THIS HEADER COMMENT PREVENTS RECONVERSION, DO NOT REMOVE
"ac" = (
/turf/closed/shuttle/argo/r5,
/area/shuttle/dropship/alamo)
"aj" = (
/obj/effect/decal/warning_stripes/thin{
	dir = 8
	},
/turf/open/shuttle/argo,
/area/shuttle/dropship/alamo)
"ao" = (
/turf/open/space/basic,
/area/shuttle/dropship/alamo)
"aw" = (
/obj/machinery/cic_maptable,
/obj/structure/table/mainship,
/obj/structure/window/reinforced/argo/toughened,
/obj/structure/window/reinforced/argo/toughened{
	dir = 4
	},
/turf/open/shuttle/argo,
/area/shuttle/dropship/alamo)
"aM" = (
/turf/open/shuttle/argo,
/area/shuttle/dropship/alamo)
"aN" = (
/obj/structure/dropship_piece/argo/bb4,
/turf/open/space/basic,
/area/shuttle/dropship/alamo)
"aQ" = (
/obj/structure/dropship_piece/argo/l10,
/turf/open/space/basic,
/area/shuttle/dropship/alamo)
"bh" = (
/turf/closed/shuttle/argo/b1,
/area/shuttle/dropship/alamo)
"bu" = (
/turf/closed/shuttle/argo/transparent/right{
	dir = 1
	},
/area/shuttle/dropship/alamo)
"bK" = (
/obj/machinery/door/airlock/hatch/cockpit/argo,
/turf/open/shuttle/argo,
/area/shuttle/dropship/alamo)
"bV" = (
/obj/effect/decal/warning_stripes/thin{
	dir = 4
	},
/turf/open/shuttle/argo,
/area/shuttle/dropship/alamo)
"bY" = (
/obj/machinery/power/smes,
/turf/open/shuttle/argo,
/area/shuttle/dropship/alamo)
"bZ" = (
/obj/structure/window/reinforced/argo{
	dir = 4
	},
/obj/structure/bed,
/obj/item/bedsheet/medical,
/turf/open/shuttle/argo,
/area/shuttle/dropship/alamo)
"cw" = (
/obj/machinery/vending/marine/shared,
/obj/machinery/light{
	dir = 4
	},
/turf/open/shuttle/argo,
/area/shuttle/dropship/alamo)
"cL" = (
/obj/machinery/autodoc,
/turf/open/shuttle/argo,
/area/shuttle/dropship/alamo)
"di" = (
/obj/machinery/autodoc_console,
/turf/open/shuttle/argo,
/area/shuttle/dropship/alamo)
"dj" = (
/turf/closed/shuttle/argo/l2,
/area/shuttle/dropship/alamo)
"dC" = (
/obj/structure/window/reinforced/argo{
	dir = 4
	},
/obj/machinery/sleeper{
	orient = "RIGHT"
	},
/turf/open/shuttle/argo,
/area/shuttle/dropship/alamo)
"dU" = (
/obj/structure/dropship_piece/argo/r10,
/turf/open/space/basic,
/area/shuttle/dropship/alamo)
"ed" = (
/obj/effect/decal/warning_stripes/thin{
	dir = 1
	},
/obj/machinery/door/airlock/dropship_hatch/argo{
	dir = 8
	},
/turf/open/floor/mainship/black/full,
/area/shuttle/dropship/alamo)
"eP" = (
/obj/effect/decal/warning_stripes/thin,
/obj/machinery/door/airlock/dropship_hatch/argo,
/turf/open/floor/mainship/black/full,
/area/shuttle/dropship/alamo)
"fp" = (
/obj/machinery/iv_drip,
/obj/structure/window/reinforced/argo{
	dir = 1
	},
/turf/open/shuttle/argo,
/area/shuttle/dropship/alamo)
"gx" = (
/obj/structure/dropship_piece/argo/l1,
/turf/open/space/basic,
/area/shuttle/dropship/alamo)
"gF" = (
/obj/structure/dropship_piece/argo/l7,
/turf/open/space/basic,
/area/shuttle/dropship/alamo)
"hl" = (
/turf/open/shuttle/argo/logo/two,
/area/shuttle/dropship/alamo)
"hr" = (
/obj/machinery/computer/security/dropship/one,
/turf/open/shuttle/argo,
/area/shuttle/dropship/alamo)
"hx" = (
/turf/closed/shuttle/argo/l5,
/area/shuttle/dropship/alamo)
"ia" = (
/obj/structure/window/reinforced/argo{
	dir = 4
	},
/obj/structure/window/reinforced/argo{
	dir = 1
	},
/obj/structure/bed,
/obj/item/bedsheet/medical,
/turf/open/shuttle/argo,
/area/shuttle/dropship/alamo)
"ib" = (
/obj/machinery/door/window/right,
/turf/open/shuttle/argo,
/area/shuttle/dropship/alamo)
"ie" = (
/obj/machinery/door/window{
	dir = 8
	},
/turf/open/shuttle/argo,
/area/shuttle/dropship/alamo)
"iC" = (
/obj/machinery/bodyscanner,
/turf/open/shuttle/argo,
/area/shuttle/dropship/alamo)
"iT" = (
/obj/machinery/computer/dropship_weapons/dropship1,
/obj/structure/window/reinforced/argo/toughened{
	dir = 4
	},
/turf/open/shuttle/argo,
/area/shuttle/dropship/alamo)
"jm" = (
/obj/structure/bed/chair/dropship/passenger{
	dir = 8
	},
/obj/effect/decal/warning_stripes/thin{
	dir = 4
	},
/obj/machinery/light{
	dir = 4
	},
/turf/open/shuttle/argo,
/area/shuttle/dropship/alamo)
"jv" = (
/obj/effect/decal/warning_stripes/thin{
	dir = 4
	},
/turf/open/floor/mainship/black/full,
/area/shuttle/dropship/alamo)
"kl" = (
/obj/structure/table/reinforced,
/obj/machinery/door/window{
	dir = 1
	},
/obj/item/reagent_containers/glass/beaker/bluespace,
/turf/open/shuttle/argo,
/area/shuttle/dropship/alamo)
"ko" = (
/obj/effect/decal/warning_stripes/thin{
	dir = 6
	},
/obj/effect/decal/warning_stripes/thin{
	dir = 10
	},
/turf/open/shuttle/argo,
/area/shuttle/dropship/alamo)
"kw" = (
/obj/machinery/bioprinter/stocked,
/obj/structure/window/reinforced/argo{
	dir = 4
	},
/obj/structure/window/reinforced/argo{
	dir = 1
	},
/turf/open/shuttle/argo,
/area/shuttle/dropship/alamo)
"kB" = (
/obj/docking_port/mobile/marine_dropship/argo,
/turf/open/shuttle/argo/catwalk,
/area/shuttle/dropship/alamo)
"kR" = (
/obj/structure/dropship_piece/argo/l8,
/turf/open/space/basic,
/area/shuttle/dropship/alamo)
"kX" = (
/obj/structure/bed/chair/dropship/passenger{
	dir = 4
	},
/obj/structure/window/reinforced/argo/window,
/obj/structure/window/reinforced/argo{
	dir = 8
	},
/turf/open/shuttle/argo,
/area/shuttle/dropship/alamo)
"lQ" = (
/obj/structure/bed/chair/comfy{
	dir = 8
	},
/obj/machinery/door/window/secure/brig/cell_1{
	dir = 8
	},
/obj/structure/window/reinforced/argo/toughened{
	dir = 1
	},
/obj/structure/window/reinforced/argo/toughened,
/obj/machinery/light{
	dir = 4
	},
/turf/open/shuttle/argo,
/area/shuttle/dropship/alamo)
"lW" = (
/obj/effect/decal/warning_stripes/thin{
	dir = 10
	},
/turf/open/shuttle/argo,
/area/shuttle/dropship/alamo)
"mt" = (
/turf/closed/shuttle/argo/b5,
/area/shuttle/dropship/alamo)
"mA" = (
/obj/effect/decal/warning_stripes/thin{
	dir = 8
	},
/turf/open/shuttle/argo/logo/seven,
/area/shuttle/dropship/alamo)
"nz" = (
/turf/closed/shuttle/argo/c2{
	dir = 8
	},
/area/shuttle/dropship/alamo)
"oa" = (
/obj/machinery/body_scanconsole,
/turf/open/shuttle/argo,
/area/shuttle/dropship/alamo)
"oz" = (
/turf/open/shuttle/argo/catwalk,
/area/shuttle/dropship/alamo)
"oA" = (
/obj/structure/dropship_piece/argo/r7,
/turf/open/space/basic,
/area/shuttle/dropship/alamo)
"oK" = (
/obj/structure/bed/chair/dropship/pilot{
	dir = 1
	},
/obj/machinery/light{
	dir = 8
	},
/turf/open/shuttle/argo,
/area/shuttle/dropship/alamo)
"oZ" = (
/obj/effect/decal/warning_stripes/thin{
	dir = 1
	},
/obj/machinery/door/airlock/dropship_hatch/argo,
/turf/open/floor/mainship/black/full,
/area/shuttle/dropship/alamo)
"qx" = (
/obj/machinery/vending/security,
/obj/structure/window/reinforced/argo/toughened,
/obj/structure/window/reinforced/argo/toughened{
	dir = 8
	},
/turf/open/shuttle/argo,
/area/shuttle/dropship/alamo)
"qP" = (
/obj/structure/dropship_piece/argo/r1,
/turf/open/space/basic,
/area/shuttle/dropship/alamo)
"rk" = (
/obj/structure/closet/secure_closet/evidence,
/obj/structure/window/reinforced/argo/toughened{
	dir = 8
	},
/turf/open/shuttle/argo,
/area/shuttle/dropship/alamo)
"rz" = (
/obj/structure/dropship_piece/argo/bb3,
/turf/open/space/basic,
/area/shuttle/dropship/alamo)
"rB" = (
/obj/structure/bed/chair/dropship/passenger{
	dir = 8
	},
/obj/machinery/light{
	dir = 4
	},
/turf/open/shuttle/argo,
/area/shuttle/dropship/alamo)
"so" = (
/obj/structure/dropship_piece/argo/ll9,
/turf/open/space/basic,
/area/shuttle/dropship/alamo)
"sr" = (
/obj/effect/decal/warning_stripes/thin{
	dir = 6
	},
/turf/open/shuttle/argo,
/area/shuttle/dropship/alamo)
"sP" = (
/turf/closed/shuttle/argo/l3,
/area/shuttle/dropship/alamo)
"sT" = (
/obj/structure/bed/chair/dropship/passenger{
	dir = 4
	},
/obj/structure/window/reinforced/argo/toughened{
	dir = 8
	},
/obj/structure/window/reinforced/argo/toughened{
	dir = 1
	},
/turf/open/shuttle/argo,
/area/shuttle/dropship/alamo)
"tB" = (
/obj/structure/dropship_piece/argo/r8,
/turf/open/space/basic,
/area/shuttle/dropship/alamo)
"tC" = (
/obj/item/radio/intercom/dropship{
	pixel_x = 21;
	pixel_y = 16
	},
/turf/open/shuttle/argo,
/area/shuttle/dropship/alamo)
"ua" = (
/turf/closed/shuttle/argo/transparent/left{
	dir = 1
	},
/area/shuttle/dropship/alamo)
"va" = (
/obj/machinery/sleep_console{
	orient = "RIGHT"
	},
/turf/open/shuttle/argo,
/area/shuttle/dropship/alamo)
"vg" = (
/obj/machinery/door/airlock/multi_tile/mainship/dropshiprear/argo{
	dir = 1
	},
/obj/effect/decal/warning_stripes/thin{
	dir = 8
	},
/turf/open/floor/mainship/black/full,
/area/shuttle/dropship/alamo)
"vF" = (
/obj/structure/bed/chair/dropship/pilot{
	dir = 1
	},
/obj/structure/window/reinforced/argo/window{
	dir = 4
	},
/turf/open/shuttle/argo,
/area/shuttle/dropship/alamo)
"vY" = (
/obj/effect/decal/warning_stripes/thin{
	dir = 8
	},
/obj/structure/bed/chair/dropship/passenger{
	dir = 4
	},
/turf/open/shuttle/argo,
/area/shuttle/dropship/alamo)
"wI" = (
/obj/structure/table/mainship,
/obj/structure/window/reinforced/argo/toughened,
/obj/machinery/cic_maptable,
/turf/open/shuttle/argo,
/area/shuttle/dropship/alamo)
"wX" = (
/obj/structure/window/reinforced/argo{
	dir = 8
	},
/obj/structure/window/reinforced/argo{
	dir = 1
	},
/obj/structure/table/mainship,
/turf/open/shuttle/argo,
/area/shuttle/dropship/alamo)
"xl" = (
/obj/machinery/loadout_vendor,
/turf/open/shuttle/argo,
/area/shuttle/dropship/alamo)
"xv" = (
/obj/structure/table/reinforced,
/obj/item/storage/surgical_tray,
/obj/structure/window/reinforced/argo{
	dir = 4
	},
/obj/structure/window/reinforced/argo,
/turf/open/shuttle/argo,
/area/shuttle/dropship/alamo)
"xZ" = (
/obj/effect/decal/warning_stripes/thin,
/turf/open/shuttle/argo,
/area/shuttle/dropship/alamo)
"yr" = (
/obj/structure/bed/chair/dropship/passenger{
	dir = 4
	},
/obj/structure/window/reinforced/argo/window{
	dir = 8
	},
/turf/open/shuttle/argo,
/area/shuttle/dropship/alamo)
"zr" = (
/obj/machinery/power/terminal,
/turf/open/shuttle/argo,
/area/shuttle/dropship/alamo)
"As" = (
/obj/structure/dropship_piece/argo/bb2,
/turf/open/space/basic,
/area/shuttle/dropship/alamo)
"Az" = (
/obj/structure/window/reinforced/argo{
	dir = 1
	},
/obj/structure/table/mainship,
/obj/item/fuelCell/full,
/obj/item/fuelCell/full,
/turf/open/shuttle/argo,
/area/shuttle/dropship/alamo)
"AC" = (
/obj/machinery/power/fusion_engine,
/turf/open/shuttle/argo,
/area/shuttle/dropship/alamo)
"Bj" = (
/obj/machinery/chem_dispenser,
/turf/open/shuttle/argo,
/area/shuttle/dropship/alamo)
"CP" = (
/obj/machinery/door/window{
	dir = 1
	},
/turf/open/shuttle/argo,
/area/shuttle/dropship/alamo)
"CX" = (
/turf/closed/shuttle/argo/l6,
/area/shuttle/dropship/alamo)
"Da" = (
/obj/machinery/door/airlock/multi_tile/mainship/dropshiprear/argo{
	dir = 2
	},
/obj/effect/decal/warning_stripes/thin{
	dir = 8
	},
/turf/open/shuttle/argo,
/area/shuttle/dropship/alamo)
"Dg" = (
/obj/structure/window/reinforced/argo{
	dir = 1
	},
/obj/machinery/light{
	dir = 8
	},
/turf/open/shuttle/argo,
/area/shuttle/dropship/alamo)
"DX" = (
/obj/effect/decal/warning_stripes/thin{
	dir = 4
	},
/turf/open/shuttle/argo/logo/three,
/area/shuttle/dropship/alamo)
"Ej" = (
/obj/machinery/light{
	dir = 4
	},
/obj/structure/bed/chair/dropship/passenger{
	dir = 8
	},
/turf/open/shuttle/argo,
/area/shuttle/dropship/alamo)
"EI" = (
/obj/machinery/computer/camera_advanced/overwatch,
/obj/structure/table/mainship,
/obj/structure/window/reinforced/argo{
	dir = 1
	},
/obj/structure/window/reinforced/argo/toughened{
	dir = 4
	},
/turf/open/shuttle/argo,
/area/shuttle/dropship/alamo)
"FB" = (
/obj/machinery/cryopod/right,
/turf/open/shuttle/argo,
/area/shuttle/dropship/alamo)
"Gg" = (
/obj/structure/dropship_piece/argo/l4,
/turf/open/space/basic,
/area/shuttle/dropship/alamo)
"Go" = (
/obj/effect/decal/warning_stripes/thin{
	dir = 4
	},
/turf/open/shuttle/argo/logo/six,
/area/shuttle/dropship/alamo)
"GA" = (
/obj/effect/decal/warning_stripes/thin{
	dir = 1
	},
/turf/open/shuttle/argo,
/area/shuttle/dropship/alamo)
"GH" = (
/obj/structure/bed/chair/comfy{
	dir = 8
	},
/obj/machinery/door/window/secure/brig/cell_2{
	dir = 8
	},
/obj/structure/window/reinforced/argo/toughened,
/turf/open/shuttle/argo,
/area/shuttle/dropship/alamo)
"IW" = (
/turf/closed/shuttle/argo/r3,
/area/shuttle/dropship/alamo)
"Jf" = (
/obj/machinery/door/window/right{
	dir = 8
	},
/turf/open/shuttle/argo,
/area/shuttle/dropship/alamo)
"Jz" = (
/obj/structure/bed/chair/dropship/passenger{
	dir = 4
	},
/obj/structure/window/reinforced/argo/toughened{
	dir = 8
	},
/turf/open/shuttle/argo,
/area/shuttle/dropship/alamo)
"Kp" = (
/obj/structure/dropship_piece/argo/bb1,
/turf/open/space/basic,
/area/shuttle/dropship/alamo)
"KH" = (
/obj/structure/bed/chair/dropship/passenger{
	dir = 8
	},
/obj/structure/window/reinforced/argo/window{
	dir = 4
	},
/turf/open/shuttle/argo,
/area/shuttle/dropship/alamo)
"Li" = (
/obj/machinery/door/window/secure{
	dir = 1
	},
/turf/open/shuttle/argo,
/area/shuttle/dropship/alamo)
"Mk" = (
/turf/open/shuttle/argo/logo/eight,
/area/shuttle/dropship/alamo)
"Mx" = (
/obj/effect/decal/warning_stripes/thin,
/obj/machinery/door/airlock/dropship_hatch/argo{
	dir = 8
	},
/turf/open/floor/mainship/black/full,
/area/shuttle/dropship/alamo)
"ML" = (
/turf/closed/shuttle/argo/r6,
/area/shuttle/dropship/alamo)
"MV" = (
/obj/machinery/door/window,
/obj/structure/window/reinforced/argo{
	dir = 4
	},
/turf/open/shuttle/argo,
/area/shuttle/dropship/alamo)
"Nw" = (
/obj/structure/window/reinforced/argo{
	dir = 4
	},
/obj/structure/window/reinforced/argo{
	dir = 1
	},
/obj/machinery/vending/medical,
/turf/open/shuttle/argo,
/area/shuttle/dropship/alamo)
"Nx" = (
/obj/effect/decal/warning_stripes/thin{
	dir = 9
	},
/obj/effect/decal/warning_stripes/thin{
	dir = 10
	},
/turf/open/shuttle/argo,
/area/shuttle/dropship/alamo)
"On" = (
/obj/structure/window/reinforced/argo,
/turf/open/shuttle/argo,
/area/shuttle/dropship/alamo)
"Op" = (
/obj/effect/decal/warning_stripes/thin{
	dir = 9
	},
/obj/effect/decal/warning_stripes/thin{
	dir = 5
	},
/turf/open/shuttle/argo,
/area/shuttle/dropship/alamo)
"Ou" = (
/obj/structure/dropship_piece/argo/r9,
/turf/open/space/basic,
/area/shuttle/dropship/alamo)
"ON" = (
/obj/effect/decal/warning_stripes/thin{
	dir = 5
	},
/obj/effect/decal/warning_stripes/thin{
	dir = 6
	},
/turf/open/shuttle/argo,
/area/shuttle/dropship/alamo)
"Qj" = (
/obj/structure/window/reinforced/argo{
	dir = 1
	},
/obj/machinery/fuelcell_recycler,
/turf/open/shuttle/argo,
/area/shuttle/dropship/alamo)
"QM" = (
/obj/structure/dropship_piece/argo/r4,
/turf/open/space/basic,
/area/shuttle/dropship/alamo)
"QW" = (
/obj/machinery/marine_selector/clothes,
/turf/open/shuttle/argo,
/area/shuttle/dropship/alamo)
"Rd" = (
/obj/machinery/computer/camera_advanced/overwatch,
/obj/structure/table/mainship,
/obj/structure/window/reinforced/argo{
	dir = 1
	},
/turf/open/shuttle/argo,
/area/shuttle/dropship/alamo)
"SP" = (
/turf/closed/shuttle/argo/b3,
/area/shuttle/dropship/alamo)
"Tn" = (
/obj/machinery/chem_master,
/obj/structure/window/reinforced/argo{
	dir = 1
	},
/obj/machinery/light{
	dir = 8
	},
/turf/open/shuttle/argo,
/area/shuttle/dropship/alamo)
"Tp" = (
/obj/structure/bed/chair/dropship/passenger{
	dir = 8
	},
/obj/effect/decal/warning_stripes/thin{
	dir = 4
	},
/obj/structure/window/reinforced/argo/window,
/turf/open/shuttle/argo,
/area/shuttle/dropship/alamo)
"Tt" = (
/obj/machinery/light{
	dir = 8
	},
/turf/open/shuttle/argo,
/area/shuttle/dropship/alamo)
"Tu" = (
/obj/structure/window/reinforced/argo{
	dir = 8
	},
/obj/machinery/vending/engivend,
/turf/open/shuttle/argo,
/area/shuttle/dropship/alamo)
"TO" = (
/obj/effect/decal/warning_stripes/thin{
	dir = 4
	},
/turf/open/shuttle/argo/logo/nine,
/area/shuttle/dropship/alamo)
"Uq" = (
/turf/closed/shuttle/argo/c1{
	dir = 1
	},
/area/shuttle/dropship/alamo)
"Vx" = (
/obj/effect/decal/warning_stripes/thin{
	dir = 8
	},
/turf/open/shuttle/argo/logo/one,
/area/shuttle/dropship/alamo)
"Vy" = (
/obj/structure/bed/chair/comfy{
	dir = 4
	},
/obj/structure/window/reinforced/argo/toughened,
/turf/open/shuttle/argo,
/area/shuttle/dropship/alamo)
"VL" = (
/obj/machinery/computer/shuttle/marine_dropship/one,
/turf/open/shuttle/argo,
/area/shuttle/dropship/alamo)
"VT" = (
/obj/machinery/door/window/secure/bridge{
	dir = 2
	},
/turf/open/shuttle/argo,
/area/shuttle/dropship/alamo)
"VW" = (
/obj/structure/window/reinforced/argo{
	dir = 8
	},
/obj/structure/table/mainship,
/turf/open/shuttle/argo,
/area/shuttle/dropship/alamo)
"Wz" = (
/turf/closed/shuttle/argo/r2,
/area/shuttle/dropship/alamo)
"WD" = (
/obj/structure/bed/chair/dropship/passenger{
	dir = 4
	},
/obj/effect/decal/warning_stripes/thin{
	dir = 8
	},
/turf/open/shuttle/argo,
/area/shuttle/dropship/alamo)
"WO" = (
/obj/structure/table/mainship,
/obj/machinery/computer/secure_data,
/obj/machinery/light{
	dir = 4
	},
/turf/open/shuttle/argo,
/area/shuttle/dropship/alamo)
"WX" = (
/obj/effect/decal/warning_stripes/thin{
	dir = 8
	},
/turf/open/shuttle/argo/logo/four,
/area/shuttle/dropship/alamo)
"Xc" = (
/turf/open/shuttle/argo/logo/five,
/area/shuttle/dropship/alamo)
"Xp" = (
/obj/structure/table/mainship,
/obj/machinery/faxmachine/brig,
/obj/structure/window/reinforced/argo/toughened,
/turf/open/shuttle/argo,
/area/shuttle/dropship/alamo)
"XW" = (
/obj/structure/bed/chair/dropship/passenger{
	dir = 4
	},
/obj/machinery/light{
	dir = 8
	},
/turf/open/shuttle/argo,
/area/shuttle/dropship/alamo)
"XZ" = (
/obj/structure/window/reinforced/argo{
	dir = 4
	},
/obj/machinery/vending/MarineMed/Blood,
/turf/open/shuttle/argo,
/area/shuttle/dropship/alamo)
"Yb" = (
/turf/closed/shuttle/argo/b4,
/area/shuttle/dropship/alamo)
"Yx" = (
/turf/closed/shuttle/argo/b2,
/area/shuttle/dropship/alamo)
"YC" = (
/obj/effect/decal/warning_stripes/thin{
	dir = 9
	},
/turf/open/shuttle/argo,
/area/shuttle/dropship/alamo)
"YJ" = (
/turf/closed/shuttle/argo/c2{
	dir = 4
	},
/area/shuttle/dropship/alamo)
"YR" = (
/obj/machinery/cryopod/right,
/obj/structure/window/reinforced/argo{
	dir = 4
	},
/turf/open/shuttle/argo,
/area/shuttle/dropship/alamo)
"Zf" = (
/obj/structure/bed/chair/dropship/passenger{
	dir = 4
	},
/obj/structure/window/reinforced/argo{
	dir = 8
	},
/turf/open/shuttle/argo,
/area/shuttle/dropship/alamo)
"Zh" = (
/obj/structure/dropship_piece/argo/bb5,
/turf/open/space/basic,
/area/shuttle/dropship/alamo)
"Zj" = (
/turf/open/floor/mainship/black/full,
/area/shuttle/dropship/alamo)
"Zw" = (
/obj/structure/bed/chair/dropship/passenger{
	dir = 8
	},
/obj/effect/decal/warning_stripes/thin{
	dir = 4
	},
/turf/open/shuttle/argo,
/area/shuttle/dropship/alamo)
"ZE" = (
/obj/machinery/optable,
/obj/item/tank/anesthetic,
/obj/item/clothing/mask/breath/medical,
/obj/structure/window/reinforced/argo,
/turf/open/shuttle/argo,
/area/shuttle/dropship/alamo)
"ZJ" = (
/obj/effect/decal/warning_stripes/thin{
	dir = 5
	},
/turf/open/shuttle/argo,
/area/shuttle/dropship/alamo)

(1,1,1) = {"
aQ
so
kR
gF
CX
hx
oZ
eP
nz
kR
gF
CX
hx
kR
gF
CX
hx
Gg
sP
dj
gx
"}
(2,1,1) = {"
ua
hr
oK
Rd
XW
wI
GA
xZ
Tn
Bj
Dg
cL
Tt
iC
XW
fp
ZE
Tt
FB
bh
Kp
"}
(3,1,1) = {"
bu
VL
tC
CP
aM
VT
Op
sr
kl
aM
CP
di
aM
oa
va
CP
On
aM
FB
Yx
As
"}
(4,1,1) = {"
Uq
iT
vF
EI
KH
aw
GA
xZ
Nw
XZ
ia
bZ
MV
ib
dC
kw
xv
ib
YR
SP
rz
"}
(5,1,1) = {"
vg
aj
aj
mA
WX
Vx
YC
lW
WD
WD
WD
WD
YC
lW
vY
WD
WD
Nx
WD
Da
ao
"}
(6,1,1) = {"
Zj
aM
aM
Mk
Xc
hl
aM
aM
oz
oz
kB
oz
oz
oz
oz
oz
oz
oz
oz
aM
ao
"}
(7,1,1) = {"
jv
bV
bV
TO
Go
DX
ZJ
sr
Zw
Zw
Zw
Zw
ZJ
sr
Zw
Zw
Zw
ON
Zw
bV
ao
"}
(8,1,1) = {"
Uq
Zf
yr
Zf
yr
kX
GA
xZ
sT
Jz
rk
qx
Jf
ie
VW
VW
wX
Jf
Tu
SP
rz
"}
(9,1,1) = {"
bK
aM
aM
aM
aM
aM
Op
ko
Li
aM
aM
Vy
aM
aM
aM
aM
Az
zr
bY
Yb
aN
"}
(10,1,1) = {"
Uq
Zw
jm
Zw
jm
Tp
GA
xZ
lQ
GH
WO
Xp
Ej
xl
cw
QW
Qj
rB
AC
mt
Zh
"}
(11,1,1) = {"
dU
Ou
tB
oA
ML
ac
ed
Mx
YJ
tB
oA
ML
ac
tB
oA
ML
ac
QM
IW
Wz
qP
"}
