//MAP CONVERTED BY dmm2tgm.py THIS HEADER COMMENT PREVENTS RECONVERSION, DO NOT REMOVE
"ac" = (
/turf/closed/shuttle/argo/r5,
/area/template_noop)
"ad" = (
/obj/structure/window/reinforced/tinted{
	dir = 4
	},
/obj/structure/window/reinforced/tinted,
/obj/machinery/vending/security,
/turf/open/shuttle/dropship/floor,
/area/shuttle/dropship/alamo)
"ao" = (
/turf/open/space/basic,
/area/template_noop)
"at" = (
/obj/structure/window/reinforced/tinted{
	dir = 1
	},
/turf/open/shuttle/dropship/floor,
/area/shuttle/dropship/alamo)
"aA" = (
/obj/structure/window/reinforced/tinted{
	dir = 8
	},
/obj/structure/toilet,
/obj/machinery/door/window,
/turf/open/shuttle/dropship/floor,
/area/shuttle/dropship/alamo)
"aN" = (
/obj/structure/dropship_piece/argo/bb4,
/turf/open/space/basic,
/area/template_noop)
"aQ" = (
/obj/structure/dropship_piece/argo/l10,
/turf/open/space/basic,
/area/template_noop)
"aU" = (
/turf/closed/shuttle/argo/c1{
	dir = 8
	},
/area/shuttle/dropship/alamo)
"aZ" = (
/obj/machinery/power/fusion_engine/random,
/obj/structure/cable,
/turf/open/shuttle/dropship/floor,
/area/shuttle/dropship/alamo)
"bh" = (
/turf/closed/shuttle/argo/b1,
/area/shuttle/dropship/alamo)
"bi" = (
/obj/structure/window/reinforced/tinted,
/obj/structure/table/mainship,
/obj/machinery/faxmachine/brig,
/turf/open/shuttle/dropship/floor,
/area/shuttle/dropship/alamo)
"bj" = (
/obj/machinery/computer/shuttle/marine_dropship/one,
/turf/open/shuttle/dropship/floor,
/area/shuttle/dropship/alamo)
"bm" = (
/obj/structure/window/reinforced/tinted,
/obj/structure/bed,
/obj/structure/window/reinforced/tinted{
	dir = 1
	},
/obj/item/bedsheet/brown,
/obj/machinery/door/window{
	dir = 8
	},
/turf/open/shuttle/dropship/floor,
/area/shuttle/dropship/alamo)
"bu" = (
/obj/machinery/door/airlock/multi_tile/mainship/dropshiprear/argo,
/turf/open/space/basic,
/area/shuttle/dropship/alamo)
"bK" = (
/obj/structure/window/reinforced/tinted{
	dir = 1
	},
/obj/structure/bed/chair/dropship/passenger,
/turf/open/shuttle/dropship/floor,
/area/shuttle/dropship/alamo)
"bY" = (
/obj/machinery/marine_selector/clothes,
/turf/open/shuttle/dropship/floor,
/area/shuttle/dropship/alamo)
"bZ" = (
/obj/structure/window/reinforced/tinted{
	dir = 4
	},
/obj/structure/window/reinforced/tinted{
	dir = 1
	},
/obj/machinery/bioprinter/stocked,
/turf/open/shuttle/dropship/floor,
/area/shuttle/dropship/alamo)
"cc" = (
/obj/structure/toilet,
/obj/machinery/door/window{
	dir = 8
	},
/turf/open/shuttle/dropship/floor,
/area/shuttle/dropship/alamo)
"di" = (
/obj/machinery/sleep_console,
/turf/open/shuttle/dropship/floor,
/area/shuttle/dropship/alamo)
"dj" = (
/turf/closed/shuttle/argo/l2,
/area/template_noop)
"dE" = (
/obj/structure/dropship_piece/argo/r7,
/turf/open/space/basic,
/area/shuttle/dropship/alamo)
"dL" = (
/obj/structure/window/reinforced/tinted{
	dir = 1
	},
/obj/structure/bed,
/obj/item/bedsheet/brown,
/obj/machinery/door/window{
	dir = 8
	},
/turf/open/shuttle/dropship/floor,
/area/shuttle/dropship/alamo)
"dU" = (
/obj/structure/dropship_piece/argo/r10,
/turf/open/space/basic,
/area/template_noop)
"ed" = (
/turf/closed/shuttle/argo/r4,
/area/template_noop)
"fA" = (
/obj/structure/bed/chair/dropship/passenger,
/turf/open/shuttle/dropship/floor,
/area/shuttle/dropship/alamo)
"gx" = (
/obj/structure/dropship_piece/argo/l1,
/turf/open/space/basic,
/area/template_noop)
"gF" = (
/obj/structure/dropship_piece/argo/l7,
/turf/open/space/basic,
/area/template_noop)
"hh" = (
/obj/structure/window/reinforced/tinted{
	dir = 4
	},
/obj/structure/toilet,
/turf/open/shuttle/dropship/floor,
/area/shuttle/dropship/alamo)
"hr" = (
/obj/structure/window/reinforced/tinted{
	dir = 1
	},
/obj/machinery/iv_drip,
/turf/open/shuttle/dropship/floor,
/area/shuttle/dropship/alamo)
"ia" = (
/obj/machinery/door/window,
/turf/open/shuttle/dropship/floor,
/area/shuttle/dropship/alamo)
"je" = (
/obj/structure/window/reinforced/tinted{
	dir = 4
	},
/obj/structure/table/mainship,
/turf/open/shuttle/dropship/floor,
/area/shuttle/dropship/alamo)
"jr" = (
/obj/structure/table/mainship,
/obj/machinery/computer/secure_data,
/turf/open/shuttle/dropship/floor,
/area/shuttle/dropship/alamo)
"jv" = (
/turf/closed/shuttle/argo/l6,
/area/template_noop)
"kR" = (
/obj/structure/dropship_piece/argo/l8,
/turf/open/space/basic,
/area/template_noop)
"mt" = (
/turf/closed/shuttle/argo/b5,
/area/shuttle/dropship/alamo)
"mT" = (
/obj/machinery/door/window{
	dir = 8
	},
/turf/open/shuttle/dropship/floor,
/area/shuttle/dropship/alamo)
"nz" = (
/turf/closed/shuttle/argo/l5,
/area/shuttle/dropship/alamo)
"ol" = (
/obj/structure/toilet,
/turf/open/shuttle/dropship/floor,
/area/shuttle/dropship/alamo)
"ox" = (
/obj/structure/window/reinforced/tinted{
	dir = 4
	},
/obj/machinery/vending/engivend,
/turf/open/shuttle/dropship/floor,
/area/shuttle/dropship/alamo)
"oA" = (
/obj/structure/dropship_piece/argo/r7,
/turf/open/space/basic,
/area/template_noop)
"oZ" = (
/turf/closed/shuttle/argo/l4,
/area/template_noop)
"pt" = (
/turf/closed/shuttle/argo/b3,
/area/shuttle/dropship/alamo)
"pY" = (
/turf/closed/shuttle/argo/c1{
	dir = 8
	},
/area/template_noop)
"qP" = (
/obj/structure/dropship_piece/argo/r1,
/turf/open/space/basic,
/area/template_noop)
"rE" = (
/obj/structure/window/reinforced/tinted{
	dir = 4
	},
/turf/open/shuttle/dropship/floor,
/area/shuttle/dropship/alamo)
"so" = (
/obj/structure/dropship_piece/argo/ll9,
/turf/open/space/basic,
/area/template_noop)
"sA" = (
/turf/closed/shuttle/argo/c1{
	dir = 4
	},
/area/template_noop)
"sC" = (
/obj/structure/table/reinforced,
/obj/machinery/door/window{
	dir = 1
	},
/obj/item/reagent_containers/glass/beaker/bluespace,
/turf/open/shuttle/dropship/floor,
/area/shuttle/dropship/alamo)
"sL" = (
/obj/structure/window/reinforced/tinted,
/obj/machinery/cic_maptable,
/obj/structure/table/mainship,
/turf/open/shuttle/dropship/floor,
/area/shuttle/dropship/alamo)
"sP" = (
/turf/closed/shuttle/argo/l3,
/area/template_noop)
"sT" = (
/obj/structure/window/reinforced/tinted{
	dir = 8
	},
/obj/structure/window/reinforced/tinted{
	dir = 1
	},
/obj/machinery/vending/MarineMed/Blood,
/turf/open/shuttle/dropship/floor,
/area/shuttle/dropship/alamo)
"th" = (
/obj/structure/window/reinforced/tinted{
	dir = 4
	},
/obj/structure/closet/secure_closet/evidence,
/turf/open/shuttle/dropship/floor,
/area/shuttle/dropship/alamo)
"tB" = (
/obj/structure/dropship_piece/argo/r8,
/turf/open/space/basic,
/area/template_noop)
"ua" = (
/turf/closed/shuttle/argo/t1,
/area/template_noop)
"uX" = (
/obj/structure/bed/chair/dropship/pilot{
	dir = 1
	},
/turf/open/shuttle/dropship/floor,
/area/shuttle/dropship/alamo)
"vg" = (
/turf/closed/shuttle/argo/t4,
/area/template_noop)
"vw" = (
/turf/closed/shuttle/argo/r5,
/area/shuttle/dropship/alamo)
"wh" = (
/obj/structure/window/reinforced/tinted{
	dir = 4
	},
/obj/machinery/door/window{
	dir = 1
	},
/turf/open/shuttle/dropship/floor,
/area/shuttle/dropship/alamo)
"wX" = (
/obj/machinery/loadout_vendor,
/turf/open/shuttle/dropship/floor,
/area/shuttle/dropship/alamo)
"xT" = (
/obj/structure/bed,
/obj/structure/window/reinforced/tinted{
	dir = 1
	},
/obj/item/bedsheet/brown,
/obj/machinery/door/window{
	dir = 8
	},
/turf/open/shuttle/dropship/floor,
/area/shuttle/dropship/alamo)
"zB" = (
/obj/structure/bed,
/obj/item/bedsheet/hos,
/obj/structure/window/reinforced/tinted{
	dir = 8
	},
/turf/open/shuttle/dropship/floor,
/area/shuttle/dropship/alamo)
"zS" = (
/obj/structure/bed/chair/dropship/passenger{
	dir = 8
	},
/turf/open/shuttle/dropship/floor,
/area/shuttle/dropship/alamo)
"zT" = (
/obj/item/radio/intercom/dropship{
	pixel_x = 21;
	pixel_y = 16
	},
/turf/open/shuttle/dropship/floor,
/area/shuttle/dropship/alamo)
"As" = (
/obj/structure/dropship_piece/argo/bb2,
/turf/open/space/basic,
/area/template_noop)
"AC" = (
/turf/closed/shuttle/argo/t5,
/area/template_noop)
"Bj" = (
/obj/structure/window/reinforced/tinted{
	dir = 8
	},
/obj/structure/window/reinforced/tinted{
	dir = 1
	},
/obj/machinery/chem_master,
/turf/open/shuttle/dropship/floor,
/area/shuttle/dropship/alamo)
"CI" = (
/obj/machinery/computer/security/dropship/one,
/turf/open/shuttle/dropship/floor,
/area/shuttle/dropship/alamo)
"CX" = (
/turf/closed/shuttle/argo/l6,
/area/shuttle/dropship/alamo)
"Dg" = (
/obj/machinery/sleeper,
/turf/open/shuttle/dropship/floor,
/area/shuttle/dropship/alamo)
"Dr" = (
/obj/structure/window/reinforced/tinted{
	dir = 8
	},
/obj/machinery/vending/medical,
/turf/open/shuttle/dropship/floor,
/area/shuttle/dropship/alamo)
"ES" = (
/obj/machinery/power/monitor,
/turf/open/shuttle/dropship/floor,
/area/shuttle/dropship/alamo)
"Fl" = (
/obj/machinery/door/airlock/dropship_hatch/argo{
	dir = 8
	},
/turf/open/space/basic,
/area/template_noop)
"Ft" = (
/obj/machinery/computer/dropship_weapons/dropship1,
/turf/open/shuttle/dropship/floor,
/area/shuttle/dropship/alamo)
"FB" = (
/obj/machinery/fuelcell_recycler,
/turf/open/shuttle/dropship/floor,
/area/shuttle/dropship/alamo)
"Gq" = (
/obj/structure/sink,
/turf/open/shuttle/dropship/floor,
/area/shuttle/dropship/alamo)
"GA" = (
/turf/closed/shuttle/argo/r6,
/area/shuttle/dropship/alamo)
"GH" = (
/obj/machinery/atmospherics/components/unary/cryo_cell,
/turf/open/shuttle/dropship/floor,
/area/shuttle/dropship/alamo)
"GO" = (
/obj/structure/window/reinforced/tinted{
	dir = 8
	},
/obj/structure/window/reinforced/tinted,
/obj/structure/bed,
/obj/structure/window/reinforced/tinted{
	dir = 1
	},
/obj/item/bedsheet/brown,
/obj/machinery/door/window,
/turf/open/shuttle/dropship/floor,
/area/shuttle/dropship/alamo)
"It" = (
/obj/structure/sink{
	dir = 8
	},
/turf/open/shuttle/dropship/floor,
/area/shuttle/dropship/alamo)
"IW" = (
/turf/closed/shuttle/argo/r3,
/area/template_noop)
"Jf" = (
/obj/structure/window/reinforced/tinted{
	dir = 8
	},
/obj/machinery/chem_dispenser,
/turf/open/shuttle/dropship/floor,
/area/shuttle/dropship/alamo)
"Kp" = (
/obj/structure/dropship_piece/argo/bb1,
/turf/open/space/basic,
/area/template_noop)
"KH" = (
/obj/structure/window/reinforced/tinted{
	dir = 1
	},
/obj/machinery/marine_selector/clothes,
/turf/open/shuttle/dropship/floor,
/area/shuttle/dropship/alamo)
"Mk" = (
/obj/structure/dropship_piece/argo/l7,
/turf/open/space/basic,
/area/shuttle/dropship/alamo)
"ML" = (
/turf/closed/shuttle/argo/r6,
/area/template_noop)
"Nn" = (
/obj/structure/window/reinforced/tinted{
	dir = 4
	},
/obj/structure/table/reinforced,
/obj/item/storage/surgical_tray,
/turf/open/shuttle/dropship/floor,
/area/shuttle/dropship/alamo)
"Nw" = (
/obj/structure/window/reinforced/tinted{
	dir = 4
	},
/obj/structure/window/reinforced/tinted{
	dir = 1
	},
/obj/item/bedsheet/medical,
/obj/structure/bed,
/turf/open/shuttle/dropship/floor,
/area/shuttle/dropship/alamo)
"Nx" = (
/turf/open/space/basic,
/area/shuttle/dropship/alamo)
"Ob" = (
/obj/structure/window/reinforced/tinted{
	dir = 1
	},
/obj/machinery/computer/camera_advanced/overwatch,
/obj/structure/table/mainship,
/turf/open/shuttle/dropship/floor,
/area/shuttle/dropship/alamo)
"Oh" = (
/obj/structure/window/reinforced/tinted{
	dir = 1
	},
/obj/structure/table/mainship,
/obj/machinery/computer/communications,
/turf/open/shuttle/dropship/floor,
/area/shuttle/dropship/alamo)
"Ou" = (
/obj/structure/dropship_piece/argo/r9,
/turf/open/space/basic,
/area/template_noop)
"ON" = (
/obj/structure/window/reinforced/tinted,
/turf/open/shuttle/dropship/floor,
/area/shuttle/dropship/alamo)
"OS" = (
/obj/machinery/optable,
/obj/item/tank/anesthetic,
/obj/item/clothing/mask/breath/medical,
/turf/open/shuttle/dropship/floor,
/area/shuttle/dropship/alamo)
"Po" = (
/turf/closed/shuttle/argo/t2,
/area/template_noop)
"Qv" = (
/obj/structure/dropship_piece/argo/bb3,
/turf/open/space/basic,
/area/template_noop)
"QW" = (
/obj/machinery/door/window{
	dir = 1
	},
/turf/open/shuttle/dropship/floor,
/area/shuttle/dropship/alamo)
"Sj" = (
/obj/machinery/door/window{
	dir = 2
	},
/turf/open/shuttle/dropship/floor,
/area/shuttle/dropship/alamo)
"Tn" = (
/obj/structure/window/reinforced/tinted{
	dir = 1
	},
/obj/machinery/bodyscanner,
/turf/open/shuttle/dropship/floor,
/area/shuttle/dropship/alamo)
"TO" = (
/obj/machinery/power/terminal{
	dir = 1
	},
/obj/structure/cable,
/turf/open/shuttle/dropship/floor,
/area/shuttle/dropship/alamo)
"TR" = (
/obj/structure/dropship_piece/argo/r8,
/turf/open/space/basic,
/area/shuttle/dropship/alamo)
"Uk" = (
/obj/structure/dropship_piece/argo/l8,
/turf/open/space/basic,
/area/shuttle/dropship/alamo)
"Uq" = (
/turf/closed/shuttle/argo/t3,
/area/template_noop)
"Us" = (
/obj/structure/window/reinforced/tinted{
	dir = 8
	},
/obj/structure/window/reinforced/tinted{
	dir = 1
	},
/obj/structure/bed,
/obj/item/bedsheet/brown,
/obj/machinery/door/window,
/turf/open/shuttle/dropship/floor,
/area/shuttle/dropship/alamo)
"Vr" = (
/obj/structure/window/reinforced/tinted,
/obj/machinery/telecomms/relay/preset/telecomms,
/turf/open/shuttle/dropship/floor,
/area/shuttle/dropship/alamo)
"VL" = (
/obj/structure/window/reinforced/tinted{
	dir = 4
	},
/obj/structure/window/reinforced/tinted{
	dir = 1
	},
/obj/structure/bed,
/obj/item/bedsheet/hos,
/turf/open/shuttle/dropship/floor,
/area/shuttle/dropship/alamo)
"VW" = (
/obj/structure/window/reinforced/tinted{
	dir = 8
	},
/obj/structure/table/mainship,
/turf/open/shuttle/dropship/floor,
/area/shuttle/dropship/alamo)
"Wz" = (
/turf/closed/shuttle/argo/r2,
/area/template_noop)
"WD" = (
/obj/structure/bed/chair/dropship/passenger{
	dir = 4
	},
/turf/open/shuttle/dropship/floor,
/area/shuttle/dropship/alamo)
"WX" = (
/obj/machinery/door/airlock/dropship_hatch/argo,
/turf/open/space/basic,
/area/template_noop)
"Xc" = (
/turf/closed/shuttle/argo/l5,
/area/template_noop)
"Xp" = (
/obj/machinery/door/window{
	dir = 1
	},
/obj/structure/window/reinforced/tinted{
	dir = 8
	},
/turf/open/shuttle/dropship/floor,
/area/shuttle/dropship/alamo)
"XN" = (
/obj/machinery/vending/marine/shared,
/turf/open/shuttle/dropship/floor,
/area/shuttle/dropship/alamo)
"XW" = (
/obj/structure/window/reinforced/tinted{
	dir = 4
	},
/obj/structure/sink{
	dir = 4
	},
/turf/open/shuttle/dropship/floor,
/area/shuttle/dropship/alamo)
"XZ" = (
/obj/structure/window/reinforced/tinted{
	dir = 4
	},
/obj/structure/bed,
/obj/item/bedsheet/medical,
/turf/open/shuttle/dropship/floor,
/area/shuttle/dropship/alamo)
"Yb" = (
/turf/closed/shuttle/argo/b4,
/area/shuttle/dropship/alamo)
"Yx" = (
/turf/closed/shuttle/argo/b2,
/area/shuttle/dropship/alamo)
"YJ" = (
/turf/closed/shuttle/argo/c1{
	dir = 4
	},
/area/shuttle/dropship/alamo)
"Zf" = (
/obj/structure/window/reinforced/tinted{
	dir = 8
	},
/obj/structure/bed,
/obj/structure/window/reinforced/tinted{
	dir = 1
	},
/obj/item/bedsheet/brown,
/obj/machinery/door/window,
/turf/open/shuttle/dropship/floor,
/area/shuttle/dropship/alamo)
"Zh" = (
/obj/structure/dropship_piece/argo/bb5,
/turf/open/space/basic,
/area/template_noop)
"Zj" = (
/turf/open/shuttle/dropship/floor,
/area/shuttle/dropship/alamo)
"Zw" = (
/obj/machinery/body_scanconsole,
/obj/machinery/door/window{
	dir = 1
	},
/turf/open/shuttle/dropship/floor,
/area/shuttle/dropship/alamo)
"ZE" = (
/obj/machinery/power/smes/preset,
/turf/open/shuttle/dropship/floor,
/area/shuttle/dropship/alamo)

(1,1,1) = {"
aQ
so
kR
gF
jv
Xc
WX
WX
aU
Uk
Mk
CX
nz
pY
WX
pY
oZ
pY
sP
dj
gx
"}
(2,1,1) = {"
ua
ol
It
QW
jr
bi
Zj
Zj
Tn
WD
Dg
hr
OS
bK
ON
ES
ZE
TO
aZ
bh
Kp
"}
(3,1,1) = {"
Po
zB
VL
at
Zj
Sj
Zj
Zj
Zw
Zj
di
QW
Zj
bK
Sj
Zj
Zj
Zj
FB
Yx
As
"}
(4,1,1) = {"
Uq
hh
XW
wh
th
ad
fA
Zj
Nw
XZ
ia
bZ
Nn
bK
ON
ox
je
rE
ia
pt
Qv
"}
(5,1,1) = {"
vg
CI
uX
Ob
WD
sL
fA
Zj
WD
WD
Zj
WD
WD
Zj
Zj
WD
WD
WD
Zj
bu
ao
"}
(6,1,1) = {"
AC
bj
zT
Zj
Zj
Zj
Zj
Zj
Zj
Zj
Zj
Zj
Zj
Zj
Zj
Zj
Zj
Zj
Zj
Nx
ao
"}
(7,1,1) = {"
Po
Ft
uX
Oh
zS
Vr
fA
Zj
zS
zS
Zj
zS
zS
Zj
Zj
zS
zS
zS
Zj
Nx
ao
"}
(8,1,1) = {"
Uq
aA
Us
Zf
Zf
GO
fA
Zj
sT
Dr
mT
Bj
Jf
bK
ON
VW
VW
VW
mT
pt
Qv
"}
(9,1,1) = {"
vg
Gq
QW
Zj
Zj
Sj
Zj
Zj
QW
Zj
Zj
sC
Zj
bK
Sj
Zj
Zj
Zj
Zj
Yb
aN
"}
(10,1,1) = {"
AC
cc
dL
xT
xT
bm
Zj
Zj
at
GH
Zj
Xp
Zj
bK
ON
KH
wX
XN
bY
mt
Zh
"}
(11,1,1) = {"
dU
Ou
tB
oA
ML
ac
Fl
Fl
YJ
TR
dE
GA
vw
sA
Fl
sA
ed
sA
IW
Wz
qP
"}
